################################################################################
#..............................................................................#
#..........#####################################################################
#..............................................................................#
#####################################################################..........#
#..............................................................................#
#..........#####################################################################
#..............................................................................#
#####################################################################..........#
#..............................................................................#
#..........#####################################################################
#..............................................................................#
#####################################################################..........#
#..............................................................................#
#..........#####################################################################
#..............................................................................#
#####################################################################..........#
#..............................................................................#
#..........#####################################################################
#..............................................................................#
#####################################################################..........#
#..............................................................................#
#..........#####################################################################
#..............................................................................#
#####################################################################..........#
#..............................................................................#
#..........#####################################################################
#..............................................................................#
################################################################################
