##################################################
####..........................................####
##...###############.#############################
##.###...........###.#############################
##.###.#########.###.#############################
##..##.#########.###.###########.............#####
###.##.#########.###.###########.###########.#####
###.##.#########.###.###########.###########.#####
###.##.#########.###.###########.###########.#####
###.##.#########.###.###########.###########.#####
###.##.#########.###.###########.###########.#####
###....#########.###.###########.###########.#####
######.#########.###.###########.###########.#####
######.#########.###############.###########.#####
######.#########.###############.###########.#####
######.#########.................###########.#####
######.#####################################.#####
######.#####################################.#####
###.......................################...#####
######.######.############################.#######
######.######.############################.#######
######.######.################.............#######
##########################################.#######
##########################################.#######
###........................................#######
###.###############################.##############
##..###############.................##############
##################################################
##################################################
