################################################################################
##.....#########################################################################
##.###.............######################################.............##########
##.####.##########.########.............#########################.##############
##.####............###################........###################.##############
##.###############.##########################...............#####.##############
##.###############.########################################.####........########
##.#############.....................######################.######.#############
##.###############################.###########.....................#############
##.###########################.............################.####################
##.#############################.##########################.####################
##.############........................####################.####################
##.############.################.##########################.####################
##.############.################..##########.........######.####################
##.#######.......################.############.############.####################
##.#############.################.############..................################
##.#############.###############..#############################.################
##.######...................#####..############################.################
##.##################.############.###########################.........#########
##.##################.############.#######...............######.################
##.#####..............############.#####################.######.################
##.#####.###############............####################.######.################
##.#####.###############################################.######.################
##.###...........##########################.....................################
##.############################################################.################
##.################################............################.################
##.###########################......#########..###############...........#######
################...............###############..........#######.################
################################################################################
################################################################################
