################################################################################
#..............................................................................#
#........###...................................................................#
#........###.................##.........................##############.........#
#........###.................##............................#######.............#
#............................##................................######..........#
#............................##............................######..............#
#............................##...............................#######..........#
#...........................................................####...............#
#..............................................................................#
#..............................................................................#
#...........##########...................#########.............................#
#...........##########.................###########.............................#
#...........##########..............##############.............................#
#................................#################.............................#
#.............................####################.............................#
#............................#####################.............................#
#..............................................................................#
######################.........................................................#
#......................................................###.....................#
#........###.........................................##..##....................#
#........###.................##....................##.....###..................#
#........###.................##...................##.......##..................#
#............................##...................###......###.................#
#............................##.....................###....##..................#
#............................##.......................###......................#
#..............................................................................#
#..............................................................................#
#..............................................................................#
#...........##########...................#########.............................#
#...........##########.................###########.............................#
#...........##########..............##############.............................#
#................................#################............##...............#
#.............................####################............###..............#
#............................#####################............####.............#
#.............................................................#####............#
######################........................................######...........#
#.............................................................#######..........#
#.............................................................########.........#
#.............................................................#######..........#
#.............................................................#####............#
#.............................................................####.............#
################################################################################
